Angry -- apoplectic
Arrogant -- hubristic
Worsen -- proliferate/exacerbate/bedevilled
weaken -- enervate/douse/sap/adulterate/hamstring/assuage
objection -- demurral
Important -- pivotal/integral/crucial/critical/essential/salient/sacrosanct
Big -- astronomical/voluminous/mammoth/colossal/incalculable
A lot of -- colossal/astronomical/exorbitant/mammoth/stratospheric/punitive(taxes etc)
Short(time) -- transient
Long(time) -- protracted
Disgusted -- grotesque
Carefully -- gingerly/perilous(v dangerous)
Comparable -- analogous to
Sad -- 
Strict -- draconian/austere
Happy -- delight
Excited -- delirious
Mixed feelings -- ambivalent
Evil -- fiendish
Easy -- homespun
Average -- run-of-the-mill
with regards to -- in respect of
Difficult -- feat/insurmountable/nonplus
Faster,speedup -- expedite
Resulting -- engenders/entails/precipitates
Beginning -- outset
Fail -- his results are always flatlined
Accidentally -- inadvertently/unwittingly
Continuously -- unremittingly/incessant/perpetuate
Unforgettable -- indelible
Deserving -- laudable
Hatable -- abominable/culpable
Instead of -- in lieu of
Very High -- stratospheric/punitive(taxes etc)
Disadvantages -- ramifications
Excellent sth -- stellar
Common -- ubiquitous/prevalent/omnipresent
elongating -- undeniably/inextricably/incontrovertibly/undoubtedly/unquestionably/inexorably -- unpreventable/perversely
clear -- unequivocal/unambiguous
Opposite -- On the other hand/ on the flip side of the coin/ adversely/ in contrast/ counter-intuitively/ in converse
Irregardless -- irrespective
cuozhe -- tribulation/ adversity/quagmire/impediment